XXXXXXXXXXXXXXXXXX
X                X
X XXXXXXXXXXXXXX X
X XS           X X
X XXXXXXXXXXXX X X
X XXXXXXXXXXXX X X
X XXXX         X X
X XXXX XXXXXXX X X
X XXXX XXXXXXX X X
X X    XXXXXXXXX X
X X XXXXXXXXXXXX X
X X XXXXXXXXXXXX X
X X            X X
X XXXXXXXXXXXX   X
X XXXXXXXXXXXXXXXX
X XXXXXXXXXXXXXXXX
XFXXXXXXXXXXXXXXXX